###################
#.................#
#.###############.#
#.#.............#.#
#.#.###########.#.#
#.#.#.........#.#.#
#.#.#.#########.#.
#.#.#...........#.#
#.#.#############.#
#.#...............#
###################