#############################################################
#.........#...#.........#.....#.............#...............#
###.#.###.#.###.#####.#.###.#.#.###.#######.#.#.###.#.#.#.#.#
#.............#.....#.......#...#...#.....#.#.....#.#.#.....#
###.#.#####.#.#####.#.#####.#####.#######.#.#.#.#.#.#.#.###.#
#...#.#.....#...#...#.............#.......#.....#...#.#.#.#.#
#.#.#.#.###.#.###.###.###.#######.#.#.#.#.#######.#.#.#.#.#.#
#.#.#.#.....#.#...#.......#.............#.............#.#.#.#
#.#.#.#.#.#.#.#.#.#.#########.#.#####.#.#.#.#.#.#####.#.#.#.#
#.#.#.#.#.......#...#.....#.......#.....#...#...#.....#.#...#
#.###.#.#########.###.#.#.#.#####.#.###.#.#.#.###.###.#.#.###
#...#.#...#.......#...#.#...#.#.......#.#...#...#.#.........#
#.#.#.#####.#.#######.#.#.###.#.###.###.#######.#.#.###.###.#
#.#.#.#...#.#.........#.......#...............#.#.#...#...#.#
#.#.#.#.#.#.#.#.#.#######.###.###.#.#.###.#####.#.#.#.#.###.#
#...#...#...#...#.............#.#.#.#...........#...#.......#
#.#.#######.#.#.#.#.#########.#.#.#.#.#.#######.#.#.#.#.#.#.#
#.................#.....#.......#.........#.......#.....#.#.#
#.#.#####.#######.#####.###.#.#########.#.#.#.#.###.###.#.###
#.#...#.........#...#...#...#...#...#...#...#.#.......#.....#
#.###.###.#.###.#.#.#.###.#.#.#.#.#.#.###.###.#.#.###.#.###.#
#...#.....#...#.....#.....#...#...#.........#...#.....#...#.#
#.#.#####.#.#.#####.#######################.#######.#######.#
#.#.....#...#.#...#.#...#...#.....................#.......#.#
#.#.###.#.###.#.#.#.#.#.#.#.#.###.#.#.#.#####.#.#.#.#.###.#.#
#.#.......#...#.#.#...#...#.......#.#.......#.....#.#.#.#...#
#.#.#.#.#.#.###.#.#####.#.#####.#.#.#.#####.###.#.#.#.#.#.#.#
#.#...#.#.#.#...#.#...#.#.#.#.....#.#.#...#.....#.#...#.#.#.#
#.#.###.#.#.#.###.#.#.#.#.#.#.###.#.#.#.#.#######.#.#.#.#.#.#
#.......#.#.........#...............#...#...........#.......#
#############################################################