#########################################
#...#.........#.....#.....#.....#.......#
###.###.#.#####.###.#.#.#.###.#.#######.#
#.#...#.#.#...........#.#.........#.....#
#.###.#.#.#.#.#.###.#.#.#########.#.###.#
#...#.#...........#.....#.....#...#...#.#
#.#.#.#.#.###.#.#.#.###.#.#.#.#.###.#.###
#.#.#.#.#...#...#...#.....#.........#...#
###.#.#.###.#.#########.#.#######.###.#.#
#...#.#...#.............#...........#.#.#
#.#.#.#.###.###.###.#.#.###########.#.#.#
#.#.#.#.......#...#.#...#...#.......#.#.#
#.###.#.#########.#.#.#.#.#.#.#######.#.#
#.....#.........#...#.......#...........#
#.#.#.#####.#.#.#.#.#.#####.###.#####.#.#
#.....#.....#.......#.#.................#
#.#########.#.#.#####.#######.#######.#.#
#.........#.#.#.......#...............#.#
###.#.#.#.###.#.#.###.#.#######.#.#####.#
#.......#...............................#
#########################################