#########################################################################################################################################################################################################
#.#...#...........#.....#.....#...#...#.........#.......#.......#.........#...............#.......#.............#.....#.....#.........#.............................#.................#...#...#.........#
#.###.#.#.#######.#.###.#.#.#.#.#.#.#.#.#######.#.#####.#.###.###.#.#.###.#.#######.###.###.#.###.#.#######.###.###.#.#.#.###.###.###.###.#####.#.#####.###.###.###.#.###.###.#.#.###.#.#.#.#.#.###.###.#
#...#...#...........#.....#.#.#.#.......#.....#...#.....#...#.#...#...#...#...#...#.........#.......#.....#.#.#.....#.#.#.....#...#.#...................#...#.....#.#.....#.#...#...#...#...#.....#.#...#
###.#.###.#####.#.#.#####.#.#.#.#.###.#.#.###.#####.#.#.#.#.###.#####.#.###.###.#.#.#####.#########.###.###.#.#####.#.#.###.###.###.#######.#####.###.###.###.###.#.#.#.###.###.#.#.#.#####.#.###.#.###.#
#.#.#.......#.#.#.........#.#...#...#...#...#...#...#.#.#.#.....#...#.......#...#.......#...#.....#.........#.........#.#...#...#.......#...#.....#...........#...#...#.#.........#.#.......#...#.#...#.#
#.#.###.###.#.#.###.#.#####.#####.#.###.#.#.###.#.###.#.#.#.#.###.#.#####.#.#.#########.#####.###.#.###.#.###.#.###.###.###.#.#.#######.#.###.#####.#.#.#.#.###.#######.#.#.#.#.###.#.#######.#.#.#.#.###
#.#...#...#...#...........#.......#...#...#...#.#.#.#.#.#.#...#...#...........#.......#.#.....#...#...#.#.#.................#...#...#...#...#...........#...#.....#.......#.#.#.....#...#.....#.#...#...#
#.###.#.#####.#######.###.###.###.###.#.###.###.#.#.#.#.#.#####.###########.#.#.#.#####.#.#####.###.#.###.#.#####.#########.###.#.#.#.#####.#.###.###.#.#.#.#.###.#.#.#.###.###########.#.#####.#.#.###.#
#.....#...#.........#...........#...#.#.#...#...#.....#.#.#...............#...#.#.............#.......#...#.#...#.............#...#.#.......#.....#...#.#...#.#.#.....#...#...........#.......#.#.....#.#
#.#####.#.#.###.#####.#######.#.#.#.#.###.###.###.#####.#.#.#.#########.#.#.#.#.#####.#####.#########.#.###.###.#.###.#.#.#######.#.#.#.#####.#.#######.#.#.#.#.#.#.###.#.#####.#######.#.###.#.###.###.#
#.......#...........#.#.........#...#.#.....#.#...#.......#.#.........#.#.#.#...#...#.....#.......#...#.......#.#.....#.#.......#...#...#...................#.....#.....#.....#.#.....#.#...#.....#.#...#
#.###.#.###.#.#####.#.#.#.#.#.#.#####.#.#####.###.#.#.#.#.###.###.#.#.#.#.#.#.###.#.#.#####.#.###.#.#####.#.#.#.#.###.#.#####.#.#.#.#.###.###.#.#.#######.#.#.#####.#.#######.#.#.###.#.###.#.###.#.#.###
#.....#.#...#.......#.#.#.......#...........#...#.#.#...#.....#.....#.#.#...#.....#.#.........#...#...#...#.........#.#.......#...#.#.....#.......#.#.....#.#.............#.........#.......#.....#.#...#
#.#.#####.#.#########.#.###.#.#.#.#.#####.#.###.#.#.###.#########.#.#.#.#.#####.#####.#.#.###.#.#####.#.#.#.#######.#.#.#.#####.#.#.###.#####.#####.#.###.#.#######.#######.###.###.###.#.#.#.###.###.#.#
#.#.#...#.#.....#.....#...#...#.#.#.......#...#.#.#.............#.#...#.#...#...#...#...#.........#.......#...........#.#.....#.#.#.#...................#.#.......#.............#...#.....#...#.........#
#.#.#.#.#.#####.#.#######.#.#.#.#.###########.#.#.#.#.#.#.#####.#.#.###.#.#.###.#.#.#####.#####.#.#.#########.#.###.#.#.#.###.#.###.#.###.###.#########.#.#.###.#.#.#########.#.#.#.#.###.#.#.#.#.#.###.#
#.#...#...#.............#.#...#.#.....#.....#.#.#.#.....#.......#.#.#.....#...#...#.#...#.#...........#.............#.#.#...#.#.....#.#.......#.........#.#.......#...#...#.........#.#...#...#...#...#.#
#.#.#######.###.###.#.#.#.#.#.#.#####.###.#.#.#.#.#.#.###.#.#.#.#.#.###.#.###.###.#.#.#.###.###.###.###.#.#######.#.#.#.#####.#####.#.#.#.#.#.#.#########.#######.#.#.#.#.#.#.#.###.###.###.#########.###
#.........#.........#.#.#.....#.......#.....#.#.#...#...#...#.#.....#...#.#...#...#.#.#.......#.........#...........#.#.....#...#...#.....#...#.#.......#.#.........#.#.#...#.....#.................#...#
#######.#.#.#########.#.###.#.#.#.#####.#####.#.#.#.###.#.#.#.#.#####.###.#.###.###.#.###.#####.#.#########.###.#.###.#####.###.#.#######.#####.#.#####.#.#######.###.#.#.#####.#.#.#.###.#######.#.#.#.#
#.........#.#.#.......#...#.#.#.#.#.#...#...#...#.......#.#...#.#.....#.....#...#.#...#...................#.......#.#...#.....#.#.#.......#.......#.....#.......#.#...#.....#...#.........#.....#...#.#.#
#.#.#######.#.#.###.#####.###.#.#.#.#.#.#.#.#########.#.#.#.###.###.###.#.#.#.###.#####.#.###############.###.#.#.#.###.###.#.#.#.#.#######.#.###.#.#.#.#.###.#.###.###.#.#.###.#.#.#.#####.#.###.###.#.#
#...#.........#.#...#.....#...#...#.#.#...#...........#...#...#...#.......#.#.#...#...#.#.......#.....#...#...#...#.#...#.....#.#.#.#.#.....#.....#.#.....#.....#...#...#.........#.....#.......#.....#.#
#.###.###.#####.###.#.#####.#.#.#.#.#.#######.#.#.###.#######.#.#.#.#.#####.#.#.#.#.#.#.#.#.###.###.#.#.#.#.#.#.#.#.#.###.#.#.#.###.#.#.###.#.#####.###.###.#.###.###.###.#######.###.#.#.###.#.#####.#.#
#.....#...#.....#...#.#.......#...#...........#.#.#.#.......#.#.....#.#.....#.#.#...#.#...#.#...........#...#.#.#...#.....#.#...#.....#...#.......#.....#...#.....#.......#.......#.......#...#...#...#.#
#.#######.#.###.#.###.#.###.#.###.#.#.#.#.#.#.#.#.#.#.#.#.#.#.#.#####.#.#.###.#.###.#.#.#.#.###########.#.###.#.#.#.#######.###.#.#.#.###.#.#.###.###.###.#.#.#.#.#.###.###.#.#.#.#.#.#######.###.#.#.#.#
#.#.......#.#.......#...#.....#.....#.#.....#...#.#.#.....#.#.#.#...#.....#...#.#...#.#.#.#.......#.....#.........#.#.......#...#.#...#.....#...#.......#...#.....#.#...........#.#.#...#.......#.......#
#.#.#####.#.#.#.###.#.#.#.###.#.#.#.#.#####.###.#.#.#####.#.#.###.#.#.#.#.#.#.#.#.#.#.#.###.#####.#.#######.#####.###.###.#.#####.#.###.#.###.#.###.#.#.###.#.###.#.#.#.#.#.#.###.#.###.#.#####.#####.#.#
#...#...#.#...#...#...#...#...#.....#.....#.......#.....#.........#.....#...#.....#...#...#.................#...........#.#.........#...#.....#...#.#.....#.#.#...#.........#...#...#...................#
#####.###.###.###.#####.###.###.#.###.###.#.#.#####.#.#####.#.#.#########.###.###.#.#.#.#.#########.#####.#.#.#.#.#.#####.#.#########.#.#.#####.#.###.###.#.###.###.#####.#.###.#.#.#.#.#.###########.#.#
#.........#.....#.#.......#.....#.............#.............#.#.....#.........#...#...#.#.#...........#...#...#.#...........#.....#...#.#.......#.........#.....#.........#.....#.#.#.#...............#.#
#.#.#######.###.#.###.###.#.#.#.#####.#.#####.#.###.#.#.#####.#####.#.#####.#######.#.###.#.#########.#.#####.#.###.#######.#.###.#.###.#.#####.###.###.###.#####.#.#.#.#.#.#####.#.#.#.###.#####.#.#.#.#
#.......#...#.....#.........#.#...........#...#...#.#.........#...#.......................#.#.....#...#.......#...#.#.......#...#...#.....#...#...#.......#.....#.........#.........#.#...#.......#...#.#
#.###.###.###.#####.###.#.#.###.#.#.#####.#.###.###.#.#####.#.#.#.#####.###.#####.###.#.#.#.###.#.#.#########.###.#.###.#.###.#.#####.#####.#####.#.#####.#.###.#.#.#.#########.###.#.#.#.#.#.#######.#.#
#.#.......#.....#...#...#...#.....#.....#.#.........#...#...#...#.....#.#...#...........#.......#.#.#...#.........#...#.....#.#.............#.....#.#.....#.#.......................#...#.#...#.......#.#
#.#.###.#######.#.#.#.#.#.#.#.#.#.###.#.#.#######.#######.###.###.###.#.#.#.#.#####.###.###########.#.#.#.#####.###.#.#.###.#.#.#.#.#.#.#####.#.#.#.#.#####.#.#####.#####.###.#########.#.#####.#.#.###.#
#...#...#...#.......#.#.#.#...#.#.#.#...#.....#...#...........#.#.....#.......#...#...#.#...........#.#.#...#.#...#.#...#...#.#.#.#.....#.....#...#...................#.#.......#.......#.#...#.#.......#
#.#.#.#.#.#.###.###.#.###.#.###.#.#.#.#####.###.#.#.###.#.#.#.#.#.#######.#.###.#.#.#.#.#.###########.#.###.#.###.###.###.###.#.#.#.#.#.#.#########.#.###.#######.###.#.#######.#.###.#.#.#.#.#.#.###.#.#
#.......#.#...#.............#...#.#.#.....#.......#...........#.#.........#.....#...#.#...#.......#...#.#.#.#.....................#.......#.......#.....#.#...#.....#.#.#...............#...#...#.#...#.#
###.#.#.#.###.###.###############.#.#####.#.#.###.###########.#.###.#.#.###.#.#######.#####.#####.#.###.#.#.#.#.#######.###.###.###.#.#####.#####.#####.#.#.#.#.#.#.#.#.#.#.#.###.###.#.###.###.###.###.#
#.....#.#.#...#...#...#.................#...#.#.....#.....#.......#.#...#.....#.............#...........#.#.........#.#.#...#.......#.#.......#.......#.....#...#...#...#.........#...#.............#...#
#.#####.#.#.#######.#.#.#.#####.#####.#.#.#.#.#.#####.#.#.#.###.#.#.#.###.#.#.#.###.#.###.#.#.###.###.#.#.#########.#.#.#.###########.#.#.#####.#.#.#.#.#########.###.#.#.#.#.#.###.#.#########.#####.#.#
#.#.#...#.#.....#...#.#.................#.....#.#.....#.#...#...#.#.....#.#.....#...#...#.#...#.........#.....#...#.#...#.............#.#.....#.....#.#...#.......#...#...#.....#...#.#.....#...........#
#.#.#.###.#####.#.###.###.#.#.###.#.###.#.###.#.#.#####.#.#.#.#.###.#.#.#.#############.#.#.###.#.###.#.#####.#.#.#.#.#####.###.#.#.#.#.#.###.###.#.#.#.#.#.#######.#.#.###.#####.#####.###.#.###.###.#.#
#.#.#.#...#.............#...............#.....#...#.#...#.#...#.......#.#...#.......#...#.......#.......#.....#.#...#.#...#...#...#.#.......#...#.#...#...#...........#.#.......#.......#.........#.....#
#.#.#.#.###.#.#######.#.#.###.###.#.#.###.###.#.###.#.#.#.#.#########.#.#.#.#.#####.#.#####.#.###.#.#.#.#.#.###.#######.#.###.#####.#.#####.###.###.###.#.###.#####.#.#.#######.#########.###.#####.#####
#.#.#.#...#.....#...#...#...#...#.#.....#.#.........#...#.#.............#.#.........#.#...#.......#.#.......#...#...#...#...#.....#...#...#...#.......#.......#.....#.#.#.....#.....#.....#...#...#.....#
#.#.#.#.#.#.#.#.#.#.#.#.#.#.###.#.#.#.###.#.#.###.#.#.###.#####.###.#.#.#.#.#.#.#.#.#.#.#.#####.#.#.#.#####.#.#.#.#.#.###.#.###.#.#.#.#.#.#.#.#######.#.###.###.###.#.#.#.#.#.#####.#.###.#.#.#.#.#.###.#
#...#.......#.....#.#.#...#...#.....#.#...#.......#.....#.....#...#.#.#...#.#...#.#.#...#.......#...#.....#.#.#...#.....#...#...........#.#...#.....#...#.....#.....#...#.#.#.#...#...#...#...#.#...#...#
###.#########.#####.#.#.#####.#.###.#.#.#######.#.#.###.###.#.#.#.#.#.#.#.#.#.###.#.#.#####.#.#.###.#####.###.#.###.#.#.#.###.###.#####.###.#.#.###.#####.###.#.###.#.#.#.#.#.#.#.#.#.#.#.#.#.#.#.#.#.###
#.#.......#...#.#...#.#.....#.....#...#.....#...#...........#.....#.#.....#.#.#.........#...#.#.#.#...........#...#.....#.#...#.......#.#...#.#.#.#...#...#.#...#...#.....#.#...#...#.........#.#.#.#...#
#.###.#.###.###.#.#######.#######.###.#####.#.###.###.#.#.#.#######.###.#.#.#.#.#.#.###.#.###.#.#.#.#.#######.#.#.#####.#.#.###.###.#.#.#.#.###.#.###.#.###.#####.###.#.###.#.#####.#.#########.#.###.#.#
#...#.#...#.#.#...#.....#.......#.#.......#.#...#.......#.........#...#...#...#...#.#...#.....#.#.....#.....#...#.....#.#.......#...#...#.......#...#...#.......#...#...#...........#...#...............#
#.#.#.###.#.#.#.###.#.#.#####.#.#.###.###.#.###.#.#.#.#.#######.#.#.#.#.#.#.#####.#.#######.###.#######.###.#####.#.#.#.#.#.#.#####.###.#.#.#.###.###.#.#######.###.#.#.###.###.#####.#.###.###.#######.#
#.#.#.....#.#...#...#.#.......#.#...#...#.....#...#.....#...#.........#.....#.....#.......#.#.#.#.....#...#.....#.#.....#.#.....#.........#.#.#.#...#.........#...#.#.#...#...#.................#.....#.#
#.#####.#.#.###.#.#.#.#.###########.#####.#.###.#.#######.#.###.#.###.#.#.###.###########.#.#.#.#.###.###.#.#.#.#.#.#.#.#.###.#.#.###########.#.#.#.#####.###.#.#.#.#.#.#.###.#.#.#####.#.###.#.#.#.#.#.#
#.............#.....#...#...#.....#...#.......#...........#.................#...........#.#...#.....#...#.....#.#.....#.#.....#.#.............#...#...#...#...........#.#.....#...#...#...#...#.#...#.#.#
#.###.#.#.###.#########.#.#.#.#.#####.#.###.#.#.#.#########.#.###.#####.###.#.#.#.###.#.#.#.#.#.###.#.#.#.###.#.#.###.#####.###.#.#####.#.#####.###.#.#.#####.###.#####.#####.###.#.#.#.#.#.#.#.#.#.#.#.#
#.#.#.......#.............#...#...#...#.........#...#.........#...............#.#...#.#.#...#.#...........#.....#...#...........#...#.#...#.....#...#.#.....#...................#.....#.#.#...#.#.....#.#
#.#.#.#####.#########.#.#.#######.#.###.#.#.#####.#.#####.#####.###.#.###.#####.###.#.#####.#.#####.#.#####.#.#.#####.###.#.#.#####.#.#.#.#.#.###.###.###.#.#########.###.#####.###.###.#.#.#.#####.#.#.#
#.#.#.....#.#.....#.#.#.#...#.....#.#.....#.......#.......#.........#...#.....#.#...#.....#.#.....#.#.....#.#...#...#.........#.......#...#.#.....#...........#.....#.....#.....#...#.......#.#...#.#...#
#.#.#####.#.###.#.#.#.#####.#.###.#.#.#######.#.#.###.#.#.###.###.###.#######.#.###.#.###.#.#####.#######.#.###.#.#.###.#.#####.#.###.#####.#.#####.#.#.#####.#.#.#.#.#.###.#####.###.###.###.#.#.#.#.###
#.#.......#.........#.......#...#...#.#.........#...#...#...#.#...#.........#.#...#.....#...#...#.#.......#.....#.#.#...........#...#.......#...........................#...#.....#...#.....#.......#...#
#.###.#.#.#.###.###.###.#.#.#.#.#######.#########.#.#.#.###.#.#.###.###.#.#.#.###.###.#.#####.###.#.###.#.#####.#.#.#####.###.#####.#.###.#.#.#.#.#########.#.###.#####.#.###.#####.#.#.###.#####.#####.#
#.....#...............#...#.............#.........#.....#.#.#.#.......#.#...#.#.........#.#.........#.....#...#...#...........#.....#.#...#...#...#.......#.....#.#.......#...#.....#.....#.........#...#
#.###.###.#####.#.#.#.#######.#.#########.###.#.#.#####.#.#.###.#####.#.#.#.#.#.#.#.#.#.#.#.#########.###.#.#.###.###########.#.###.#.#.#####.###.#.###.#.#####.#.#.#######.#.#.#.#.#####.#####.#.#.#.###
#.#...........#...#...#.....#.#.........#...#.#.#.....#.........#...............#.#.#.......#.........#.....#.....#...#...#.#.#...#.#...#.........#...#.#.#.....#...#.......#...#.#...#...#...#.#.#.#...#
#.#.#.###.#.#####.###.#.#.#.###.#.#.###.#.#.#.#######.#.#.#.#.#.#.#####.###.#####.#.###.#.#.#.#.#####.###.#######.#.#.#.#.#.#.#.#.###.#.#.#.#.#.###.###.#.#.#.#.#################.#.#.#####.#.###.#.#.#.#
#...#.....#...#.......#.#.#...........#.#.#...#...#...#.#.#.......#...#.........#...#.......#...#...#...#...#...#.#.....#...#.#.......#...#...#.....#.............#...............#...#.....#.....#.#...#
#.###.#.#.#.#.#.#####.#.#.###########.#.#.#.#.#.#.#.###.#.#.#####.#.#.###.###.###.#####.#######.###.###.#.###.#.#.#.#########.#.###.#.###.#.#.#.#####.###.#.#####.#.#.#########.#.#.#.#.#######.#####.#.#
#.#...#.#...#.....#...#.#.#...#.....#.#...#.#...#.#.#.....#.#.....#.#...#.#...#.......#.#.........#.....#...........#.......#.#.#...#...#.#.#.......#...#...#...#.#...........#...#.....#...............#
#.#####.#.#########.#####.#.#.#.###.#.#.###.###.#.#.#.#####.#.#.#####.###.#.###.###.#.#.#.###.###.#.#.#.###.#.#######.#####.#.###.#####.#.#.#.#######.#.#######.#.#.#.#####.#.#.###.#.###.#.#.###.#####.#
#...#.......#...#.........#.#.#.#.#...#...#...#.............#.#.#.....#...#.....#...#.....#...#...#.#.#.....#.......#...#...#.#...#.......#.#...#...#.#...#.....#.#.#.....#.#...#.#.#...........#.#.....#
#.#.#.#####.###.#.###.#######.#.#.#.#####.#.#.###.#.#.###.#.#.#.#.#.#.#.#######.#.###.#######.#.###.#.#####.###.###.###.#.###.#.###.#.###.#.#.#.#.#.#.#.###.#.#.#.#.###.#.#.#.#.#.#.#.#.#.#######.###.#.#
#...#.#.........#.....#...#.....#.....#...#.#...#.#.#.....#.#.#.#.#.#.#.#.........#.............#.....#...#...#.#.#.#...#.#...#.....#...#.#.#.#...#...#.....#...#...#.#.....#.....#.#...#.#...........#.#
#.###.#.#.#####.#####.#.#.#.###.#.#.#.#.#.#.###.#.#.#######.###.###.#.#.#######.###.###.#.###.#.#.#.#.###.###.#.#.#.#.###.#.###.#.#.###.###.#.#.###.#####.###.#.#.#.#.#.#########.#.###.#.#.###.#####.#.#
#.#.....#.....#.........#...#...#.#.#...#.....#.#.........#...#...#...............#...#...#.....#...#.......#...#.......#...#.#.#.#.#.#.....#.#.#...#...#.#.#.#...#...#...#.......#...#.#...............#
#.#.#######.#.###.#.#.#.#.###.###.#.###.#######.#.#######.#.#.###.###.#####.#.###.###.#.#.#####.###.#########.#####.###.#####.#.#.#.#.#.#######.#.###.#.#.#.#.###.###.###.#.###.#####.###.#.###########.#
#.#...#.....#.........#.#.....#.....#...#.......#.........#.#...#...#...#...#.......#.#.#.#...#...#...#.......#...#.............#...#.....#.....#...........#.....#.#.#...#.#...#...#.....#.#.....#.#...#
#.###.#.#.#.#####.#.###.#.#.###.#.###.###.###.###########.#.###.###.#.#.#####.#.#.#.#.#.#.#.#.#.#.###.#.#####.#.#.#.#.###.#.#.#.#.###.#.#.###.#.#.#.#.#.#.#.#.#.###.#.#.#.#.#.#.#.#.#.#.###.#.###.#.#.###
#.......#...#...#...#...#.#.........#...#...#.....#...#.......#.#...#.#.......#...#...#.#...#...#...#.........#.#...#...#.#.#.#.......#.#.....#.#...#...#.#.#...#.............#...#...#...#.......#...#.#
#######.#.#.#.#.###.#.###.#####.#.#.#.#####.#.#.#.#.#.#.#####.#.#.###.###.#.###.#.###.#.#####.###.#.#.###.#####.#.#####.###.#####.#.#.#.#.#.#.###.#.#.#.#.#.#.###.#.###########.#####.###.#####.###.###.#
#.....#.....#.#.......#...#.....#.#.#.#.....#.#.....#...................#.....#.#...#.#...........#...........#.#.........#.......#.#.......#.#...#...#...#.#.............#...#.#...#.........#.#...#...#
#.###.#.#####.###.#########.#####.#.#.#.#####.#.#########.#####.#######.#######.###.#.###.###.###.#.#####.###.#.#.#######.###.###.###.#.#####.#.#.#####.#.#.#.#.###.#####.#.#.###.#.###.#.#.#.#.#.#####.#
#.......#.....#.#.......#.......................#.......#.........#...........#.#...#...#.....#.........#.#.#...#.#.....#.........#.....#.....#...#...#.#.#.#...............#.#...#.#...#.#.#...#.#.....#
#.#####.#.#####.#.#####.#.#####.###.###.#.#####.#####.#.#.#.###.#.#.###.#####.#.#.#.###.#.###.#.#.#.#.#.#.#.#####.#.###.###.#####.#.###.#.#.#.#.###.#.#.#.#.#.#.#######.#.###.#.###.###.#.#.#.###.#.#####
#...#...#.#.....#...#.................#...#...#...#...#...#...#.#.#.#.......#.#.#...........#.#.......#.#.....#.....#.....#.#.....#.....#...............#...#.#.#...#...........#.#...#.........#.#.....#
#.#.#.###.#.###.#.#.#.#.#####.#######.#.###.#.#.#.#.#######.#.#.#.#.#.#.#.#.#.#.#####.#.###.#####.###.#.#####.#######.#.###.#.###.#.#####.#######.###.#.#.###.###.#.#.###.#.#####.#.#.###.#####.#.###.#.#
#.#.#.......#.#.....#.#.......#...#...#.#...#.#.....#...............#...#.#.#.......#.....#.....#.....#...............#.#...#...#.........#.......#.#...#...#.....#...#...#...........#.........#.....#.#
#.#.#.#.###.#.#.#.###.#####.#.#.#.#.###.#.###.#.#####.#####.#########.#.#.#.#.#.###.###.#.#.###.###.#.#.#.#.###########.#.#####.#.#.###.###.#####.#.#######.#.#.###.#.#.#.#############.#.#########.###.#
#.#...#.....#...#...#...#.......#.......#...#.#.#.........#...........#...#.#.#...#.#.....#...#...#.#...#.....#...#...#.#...#...#.....#.................#.#...#.#...#.....#...#...................#.#...#
#.#.#.###.###.#.#.#.###.#.###.#.###.#######.#.#.#.###########.#.#####.#.###.#.###.#.#.#.#.#.#####.#.###.#####.###.#.#.#.###.#.#.#####.#.#######.#.#.###.#.#.#.###.###.###.#.#.#.#.###.###.#.#.###.#.#.#.#
#.#.#.#.#.........#...#...#...#...#.#.......#.#...#...........#.....#.#...#.#...#...#.#.#.......#...#...#...#...#...#.....#.#.......#.#.#.....#...................#.......#.#.......#.#...#.#.....#.#...#
#.#.#.#.#.#####.###.#.#.#.###.###.#.#.#.###.#.###.#.###.#.###.#.###.#.###.#####.#.#.#.#.#######.#####.###.#.#.#.#.#######.#.#.#######.#.#.###.#.#########.#########.#.#####.#######.#.#.###.#.###.#.#.#.#
#...#.........#.....#.#.........#...#...#...#.....#.#...#.....#.................#.#...#...................#.#.....#.........#.#.......#.#.#...............#.........#.#.....#.....#.#.#...#.#.#.#...#.#.#
#.#.#####.#.#.#.#####.#.#.#.#.#.###.###.#.#.#.#.#.#.#.#.#.#.###.###########.#.#.#.#####.###.#.#####.#######.#.#.#.#.#.#####.#.#.#.#.#.#.#.#.#####.#.#.#.#.#.###.###.#.#.#.###.###.###.###.#.#.#.#####.#.#
#.#.....#.............#...#.#.........#.#.#...#.#.#...#.#.......#.......#...#...#...............#.#.........#.#...#.#.......#.....#.#.#.#.........#.#.#.#.....#.....#.........#.#...#...#.#.#...#...#...#
#.#####.#########.#######.#.#.#######.#.#.#.#.#.#.#####.###.#.###.#.###.#.#################.###.#.###########.#.###.###.###.#.###.#.#.#.#.#.#.#.###.#.#.#####.###.#.#.#######.#.#.#.#.#.#.#.###.#.#.#.#.#
#.........................#.#.................#.......................#.........................#.................................#.....#.............#.......................#.........#.#.......#...#.#
#########################################################################################################################################################################################################