#######
#.#...#
#.#.#.#
#...#.#
#.#.###
#.#...#
#######