#############################################################
#.#.......#...#.#.....#.............#...........#.....#.....#
#.###.###.#.#.#.#####.#.#####.#############.#.#.###.#####.###
#.......#.#.#...#.........#...#.#.........#.#.#.......#...#.#
#.#####.#######.#######.#.###.#.#.#.#.#.###.#######.###.#.#.#
#.#.#.#.#...#.........#.#...#.#...#.#.#...#.#...#.....#.#...#
#.#.#.###.#.###.#####.###.###.#.###.#.#######.#.#.#########.#
#.......#.#.#.#...#...#...#.......#.#.......#.#.......#...#.#
#.###.#####.#.###.#######.#####.#.#####.###.#####.###.###.#.#
#...#...#...#...#.#.......#.....#.#.....#...#...#.#.#.....#.#
#.###.###.###.#.#.#.#######.#.#.#####.###.#.#.#.###.###.###.#
#.#.#...#.#...#.........#.#.#.#.#.......#.#.#.#.#.#...#.#...#
#.#.###.#.#.###.#########.#.#.#.###.#####.###.###.###.#.#.###
#.#.#.....#.#...#.#.......#.#.#.#...#...#.#.#.#...#...#.....#
#.#.###.#####.#.#.#####.#.###.###.###.#.###.#.#.#.#.#.###.###
#.....#...#...#.......#.#...#.#.....#.#.#.#.....#...#.......#
###.###.#.###.#.#.#####.#########.#.#.###.#####.###.#.#####.#
#...#...#.#.#.#.#...#.....#.#.#.#.#...#...#...#...#.#.#...#.#
#.#.###.###.###.#.###.#.###.#.#.#.#######.###.#######.###.#.#
#.#...#.#...#...#...#.#...#...................#...#.......#.#
#.###.###.#######.#######.#######.#.###.#.#######.#.#####.#.#
#.#...........#...#.#.#.....#.#...#...#.#.....#.......#.#.#.#
###.#####.#.#####.#.#.#.#####.###.#.#.###.#.#.#.#######.###.#
#.#.#...#.#...............#.#...#.#.#.#...#.#.#...........#.#
#.#.#.###.#.#########.#####.###.#####.###.#####.#.#####.#####
#.#.#.....#.....#...#.#...........#...#.........#.#.#.#...#.#
#.###.#####.#######.#.#######.###########.#######.#.#.#####.#
#.#...#.#.#...#.......#.#.#...#...#.........#.........#...#.#
#.#.###.#.#.#########.#.#.###.###.#.###.###.#.#####.#.#.###.#
#.....#.....#.................#.......#...#.#.....#.#.......#
#############################################################