#####################
#...#...#...........#
#.###.#.#.###.#####.#
#...#.#.#...#...#.#.#
###.#.#.#.#.###.#.###
#.....#.#.#...#...#.#
#.#####.###.###.#.#.#
#...#.#.#.....#.#...#
#.#.#.#####.###.###.#
#.#.........#...#...#
#####################