###########
#...#.....#
#.###.###.#
#...#...#.#
#.#.#.#####
#.#...#...#
#####.#.###
#.#...#...#
#.#.###.#.#
#.......#.#
###########