#########################################################################################################################################################################################################
#...#...........#...#.#.#.#...#.....#.......#.......#.#...#.#.#...#.#.#.....#.....#...#.#.#.....#.....#.#...#.......#.#.........#.#...#.........#.#.........#.......#.#...#...#.....#...#.#...#.........#
#.#.#.#.#.#.#####.###.#.#.#.###.###.#.#.#####.#.#####.###.#.#.#.###.#.#.#.#.###.###.###.#.#.###.#.#####.#.#.#.#.#.#.#.#.#.#####.#.#.###########.#.#.###.###.###.#####.#.###.###.###.###.#.#.#####.#####.#
#.#.#.#.#.#...#.#...#...#.#.#.#.#.#...#...#...#.#.......#...#.........#.#.#.#...#.#.#.#...#.#.....#.#.....#...#.#.#.#...#...#.....#...#.........#.....#...#...#.#.#...#...........#.#.#...#...#.......#.#
#.#.#######.###.#.###.###.#.#.#.#.#######.#.###.#.#########.###.#.#.###.###.###.#.#.#.###.#.###.#.#.###.###.#.#.###.###.#.#######.#.###.#####.###.#.#.#.#.#.###.#.#.###############.#.#.###.#####.#.#####
#.#.....#...#.#.....#...#.........#...#.#...#.....#...#.#.#...#.#.#.......#.#.............#...#.#.......#.#.#.#.#...#.#.#.......#.#.....#...#...#.#.#.#.#.#.#...#.........#.#.#.....#.#.#.........#.#...#
###.###.###.#.###.#.#.#.###.#########.#.#.#####.#.###.#.#.###.#.#########.#####.#.#.#.###.#####.#.###.###.###.#.#####.#.###.#.#.###########.#.###.###########.###.#######.#.#.#####.#.#.#.###.###.###.#.#
#.#.#.....#.....#.#...#.#.#...#.......#.....#...#.#...#.......#.#...#.......#.#.#.#.#.#...#.....#...#.#.......#.#.#.....#.#.#.#.#.#.#.#.........#.#.#.........#.#.#.#.........#.....#.....#...#.#.#.#.#.#
#.#######.#.###.#####.###.#.#####.###.###.###.#####.###.#####.#.#.#.#.#####.#.#.###.#.###.#.#.###.#.#########.###.#######.#.#.###.#.#.###.###.###.#.#.#.#.###.#.#.#.#.#######.#####.###.#####.#.###.#.#.#
#.#.....#...#.....#.#...#...#.#.....#...#.#.......#...#.....#.#...#.#.....#.#...#...#...#.#.#...#.#.#.......#...#.#.#.......#.........#.#.#.#.....#.#.#.#.#.#.......#.#...#.....#.........#.....#.....#.#
#.#.#.###.#########.#.#.###.#.#.###########.###.#####.#.###.###.#####.#####.###.#.###.###.###.#####.#.#######.#.#.#.#.#.#####.#######.#.#.#.#####.#.###.#.#.#.###########.#####.#.#####.###.###.#####.###
#...#.#.#.....#.......#.#...........#.#.#.#.#.#...#...#.#...#.#.#...#.#.#.#...#.#.#...#.#.....#...#.#.....#...#.#...#.#.....#.......#.........#.#...#...#...#.#.#...#...#.......#.#.#...#.#.#...#...#.#.#
#.#####.#####.#.#######.#####.#.#####.#.#.#.#.#.#.###.#.###.#.###.###.#.#.#############.#.###.#.#.#.#.#####.#####.#############.#####.#.#.###.#.#.#.#######.###.#.#####.#######.###.###.#.###.#.#.###.#.#
#.......#.......#...#.......#.#...#...#.....#...#.....#.#.#...#.#.....#...#.......#.........#...#.#.#.......#.#.......#...#...#.#.#...#.#.#.....#.#...............#...#.#...#.....#.......#...#.#...#...#
#.###########.#.#.#.#.#.#.#.#.#.#.###.#######.#########.#.#####.###.#.#.#####.#######.###.###.#.###.###.###.#.#.#########.#.#####.#.#####.#####.#.#.#.#######.###.#.###.#.###.#.#######.#.#.#.#.###.#.#.#
#.#.#.#.......#.#.#...#.#.#.#.#.#.#.#.......#.......#.#.#...#...#...#.#.......#.#.#.#.#...#...#.#...#.....#.#.#...#.....#.#.#.#...#.#.......#...#.#.#...#.#...#...#.#.....#...#.#.#.....#.#.#.#.....#.#.#
#.#.#.#.###########.###.###.#####.#.#####.###.#####.#.#.#.#.#.#######.#.#######.#.#.#.#######.#####.#.###.###.#.#######.#.#.#.###.#.#####.#########.#####.#####.#.#.#.#######.###.#########.#########.#.#
#.....#.#.#.#.#...#.#.....#.#.....#.............#...#.#...#.....#.#.........#...#...#...#.#...#.#...#.#...#...........#...#.........#.#.#...#.....#.........#...#...#...#...#.........#...#.....#...#.#.#
#####.###.#.#.###.#########.#.###.#.#.###########.###.###.#######.#######.#.###.#.#.#.###.###.#.###.###.#.###.#######.#.#####.#.#.###.#.###.#.#######.#.#########.#.#.###.#.#.###.###.#.#.#.###.#.###.###
#.........#.#...#.#.#.........#.#.#.#...#...#.........#.#.#...#...#.......#.#...#.#...#...........#...#.#...#.....#...#.#.....#.#...#.#...#.....#...#.#.#.#.#...#.#.#.....#.#...#...#.#.#.#...#.......#.#
###.###.###.#.#.#.#.#.###.#####.###.###.#.#######.###.#.#.#.#####.#####.###.###.#.#######.###.###.#.#####.#######.#####.###.#.#####.#.###.#.#####.###.###.#.###.###.#.#.#.#########.#####.#.###.###.###.#
#.#.#.#.#.....#...#.....#...#...#...#.....#.#.#.#...#.#.....#.......#.#.#.......#.#.#...#.#.....#.#.#.......#...........#.#.#.#.......#.............#.#.#.#.......#...#.#.....#.#.......#.....#.#.....#.#
#.#.#.#####.###.###.#########.#########.#.#.#.#.#######.###########.#.###.#.###.#.#.###.#####################.#.#.#.###.#.#####.#.#.#########.#######.#.#.###.###############.#.#######.#####.#########.#
#.............#.#.....#.....#.#.........#.#.................#.#.....#...#.#.#.....#.......#...........#.....#.#.#.#.#...#.....#.#.#.......#.#.#.....#...#.........#.#.......#...#...............#.....#.#
#.#######.###############.###.#.#####.###.###.###.#.###.###.#.#.#######.#.###.###.#.#####.#.#########.#.###.#.#####.#####.#####.#.###.#.###.###.#####.#####.###.###.#####.###.###.###.###.#.#####.###.#.#
#...#.#.#...#.................#.#...#.#.......#.#.#.#.....#.#...#.#.#.......#.#.#.#.....#.#.#.#.#.........#.......#.......#.#...#.#...#.#...#...............#.#...#.......#...#.#...#...#.#...#.#...#.#.#
#.#.#.#.#.#############.###.#.#####.#######.###.###.#.#########.#.#.###.#.#####.#.#####.###.#.#.#####.###.###.#.#######.###.#######.#.#####.###.#.###.#.#.#.#.#######.###.#####.#####.#.###.#.#.#.###.#.#
#.#.#.....#.....#.......#...#.#...#.......#.....#...#.#.#...#...#.#.#.#.#.#...#...#.......#.......#...#.#.#...#.#...#.#...#...#.#.#.#.........#.#.#.#.#.#.#...#.......#.....#.#.......#.#...#.....#.#...#
#.#######.#.#######.###.#.###.#.###.###.#######.#######.###.#.#.#.#.#.###.#.#.#.#########.#######.#.#.#.#########.###.###.#.###.#.#.###.#####.#.###.###.#.#######.#######.###.#.###.#####.#####.###.###.#
#.#.#.....#...#.#.#...#.#...#.....#.#...#.#.............#.#...#...#.#...#...#.#.#.....#...#.....#.#.#...#.......#.....#.#.#.#.#...#.#...#.....#.#...#.#.#.#.#...#.....#.#.#.#.#...#.#...#.....#.#.......#
#.#.###.#####.#.#.#######.###.###.#.#####.#.#.###.###.###.#.###.#.#.###.#.#.#.#######.#.###.#.###.#.#####.#####.#.###.#.#.#.#.###.###.#######.#####.#.#.###.#.###.###.#.###.#.#.#.###.###########.#.#.###
#.#...#...............#...#.....#.#...#.....#.#.#...#...#.#.#.#.#.#.......#.#.....#.#.#.#...#.....#.#.#.#.#.....#.#...#.......#...#.......#.....#.#.#.#.#.......#.#.....#.#.....#.......#...#...#.#.#.#.#
###.#####.#####.#.###.###.###.#.#####.#.#.#####.#########.#.#.#####.#.#.#########.#.#.#.#########.###.#.###.###.#####.###.#######.###.#.#.###.###.#.#.###.#.###.#.#.#.#.#.#.#.#####.#.###.###.###.#####.#
#...#...#...#.#.#...#.#...#.#.#.....#.#.#.#.........#.#.........#...#.#.#.....#.........#.....#.....#.#.......#.......#.......#.....#.#.#.#...#.#.#.....#.#...#...#.#.#.#.#.#.#.#...#.#.................#
###.###.###.#.#.###.#.#.###.###.###.#.###.#.###.#####.###.#.###.#######.#.#.###.#######.#.#######.###.#.###.#####.#.#######.###.#.###.#####.###.#.#.#.###.###.#######.###.#.#.#.#.#####.###.###.###.#####
#.#...........#...#.#...#.......#.#.#...#.....#.....#.#...#...#.#.......#.#.....#.#.......#.#.#.#.....#.#.....#...#...#...#.#...#...#.....#...#...#.#.#...#.......#.....#...#...#.#.#...#.#.#.....#.#.#.#
#.#.#.#####.#.#######.#.###.#####.#.###.#.#####.###.#.#.###.#####.#########.#####.#.#######.#.#.###.###.###.#########.#.#########.#####.#####.#.###.###.###.###.#.###.###.#########.###.#.###.###.###.#.#
#...#.....#.#.....#...#...#.#...#...........#.....#.#.#.#.....#.....#.....#.....#...#...#.......#...#.....#...#...........#...#...#.#.#.#.#.#.........#.#.#.#...#...#.#...#.......#.......#.....#.#.#...#
###.#.#####.#######.#.#.#.###.#.###.#.#####.###.###.#.#######.#.#######.#.#######.#.#.#.#.#.###.#.#####.#########.#.#####.#.#####.#.#.#.#.#.#######.#.#.#.#.#############.#####.#######.#.#######.#.#.###
#...#...#.....#.#...#.#.#...#.#...#.#.....#.#...#.#...........#...#...#.#.#.......#...#...#.#...#.#...#...#...#.#.#.#.....#...........#...#.#.....#.#...#.........#.#...#.#.......#...#.#.#...#.........#
#.###.###.#.###.###.#.#.#####.#.#####.#####.###.#.###########.###.#.#.#.#.#.#######.#####.###.#.#.#.#.#####.###.###.#########.#############.#.#.#.#.###.#.#####.###.#.#########.#.#.#######.###.#.#.###.#
#.#.#...#.#.#...#...#.#.#.#...#.#.......#.....#.#...#...#.#.#.....#.#...#.....#.#...#.#.#...#.#...#.#.#.#...........#.#.#.......#.....#.......#.#.....#.#.#.#.....#.......#.#...#.#...#.#...#...#.#.#...#
###.#####.###.#######.###.#.#.#####.###.#.#######.#####.#.#.###.#######.#######.#.###.#.#####.###.###.#.###.#.#.###.#.#.#.#.###.#.#.#######.###.#.#######.#.#####.#.###.###.#.#.###.###.###.#.###.#######
#.......#.....#.#...#.......#.#.#...#...#...#...#...#...#...#...#.......#...#...#.....#...#...#.....#.#...#.#.#...#...#.#.#...#.#.#...#...#.#.#.#...#.....#.........#.....#.#.#.......#...#.#...#...#...#
#.#########.#.#.###.###.#.#####.###.#####.#####.#.#.#.#.#.###.#########.#.###.#.#####.#.###.###.###.#.#.#.#.#######.###.###.#######.#####.###.#.#.#########.#####.#########.###.#.#.#####.#.#.#########.#
#.......#.#.#.....#.#...#.#...#.#...#.....#.....#.#.#.#.........#...#...#.....#.#...#.#...#.#...#.......#...#.#.#.....#.#...#...#...........#...#...#.#...#.....#.#...#...#.#...#.#.#.....#.#...#...#...#
#####.#.#.#####.###.###.###.###.#############.###.#####.#######.#.#########.#.#.###.#.#.###########.#.###.###.#.#####.#.###.###.#.###.#####.#######.#.#.#####.#######.#.###.#######.#.###.#.#####.###.#.#
#...#.#.....#.#.......#...#...#...........#.........#.#.....#...........#.#.#.#...#.#.#...#.#...#...#.#.......#.#...#.....#.......#.....#.......#...........#.....#.#...#...#.#.....#.#.....#.#.......#.#
###.#####.###.#.###.###.#.#.###.###.#.#######.#####.#.#.#######.#######.#.#####.#.#.#####.#.#.#############.###.###.#.#.#.#.###.#######.#########.#.#.#.#.#.###.###.###.###.#.#####.#######.#.#.#####.#.#
#.#...#.......#...#...#.#.........#.#.....#.....#...#.#.......#.....#...#.#...#.#.........#...#...#.#...#.#.#.#.......#.#...#.#.#.........#...#...#.#.#.#.#...#.#...#.......#.....#...........#.#...#.#.#
#.#.#####.###.###.#.#######.#.#.#########.#.#########.#####.#######.#####.#.###.###.#.#.#.###.#.###.#.#.#.#.#.###.#.#.###.###.#######.#.###.###############.#.#####.###.#####.#.#.###.###.###.#####.#.#.#
#...#.....#.#.#...#.#.....#.#.#.....#...............#.#...#.#.....#...#.....#.#...#.#.#.#.#...#.#.#...#.#.......#.#.#.#...........#...#...#.#.........#.....#.......#.....#...#.#...#.#...#...#.#.....#.#
#.#.###.###.#.###.#####.#.#.###############.#######.#.#.#.###.#.###.###.###.#.#####.#####.#.#.#.#.#.#.###.###.#.#.#.###.#######.#.#.#######.###.#.#########.#######.###.#.#.#####.#.#########.#.#####.###
#.#.#.......#...#.....#.#...#.#.........#...#.#.........#.....#.#...#...#.#.........#.......#...#...#.#.....#.#.#.#...#.#.#.....#.#...#.#...#...#.......#.......#.#.#...#.#.....#.#...#.........#.#.#.#.#
#.#####.#.###.#####.#.#.#####.###.#.###.#####.#.#####.#.#####.#######.###.###.#.#####.#####.#.###.#####.#######.#####.###.###.#.#####.#.###.#.#.#####.#######.#.#.#.#####.###.#.#.###.#.#.#.#.###.#.#.#.#
#.......#.#...#...#.#.#.....#...#.#...#.......#.#.....#...#.#.....#.#.....#...#...#...#.....#.#.....#.........#.#...#...#.....#...#.#.........#.#.....#.......#.#...#...#.#...#.#...#...#.#.#.#.#.......#
###.#######.###.#.#.#######.#.#######.#######.#.###.#.#.#.#.###.###.#.#.#########.#######.#######.#####.###########.#.#.#######.###.#.#####.#.###.#.#.#######.#.#####.#.#.#.###.#.###.###.###.#.###.###.#
#.#...#.......#.#...#.#.............#.#...#...#.#...#.#.#...#.....#.#.#.#.....#.#.....#.#.#.#...#.......#.....#.#.#...#...#...#...#.....#.#.#.#...#.#.#.#.....#.#...#.#...#...#.#.#.#.#.#...#...#.....#.#
#.#.#######.#####.###.#####.#####.#######.#.#.#####.###.###.#######.#.#######.#.#.#####.###.###.###.#.###.#.###.#.#.#.###.#.#############.#.###.#######.#.###.#.#.#.#.###.#.#####.#.#.#.#####.#.###.#.###
#.#...#...#...#.#.....#.....#.......#.....#.#.......#.#...#.....#...#.#.....#...#.#.....#...#...#...#.#...#.#...#...#.#.#.....#.#.#.........#.........#.....#.#.#.#.#.#.#...#.....#.#.#...#.#.#...#.#...#
#.#.#####.###.#.#.#########.###.#.###.#####.#########.#.#####.#.#.###.###.###.#####.#####.#.#.#.###.###.#.###.#########.#######.#.#######.#.###########.###.#####.#.###.#####.#.#.#.###.#.#.###.#.#####.#
#.....#.............#.#.......#.#...#...#.#.....#.#.....#.#.#.#.#.....#...#...#.#.#.#.....#...#.....#...#...#.#.....#.#.#.............#...#.....#.#.......#.....#.#.#...#.....#.#.#...#.#.....#.#.....#.#
#.#.#.###########.###.###.#####.#.#####.#.###.###.#####.#.#.###.###.#.###.#.#.#.#.#.#.#####.#######.#.#####.#.#.#.#.#.#.###########.#######.#.#.#.###.###.#####.###.###.###.#####.#.#####.#####.###.#.#.#
#.#.#.....#...#.......#.....#...#.........#...#.#.....#.....#.....#.#.....#.#...#.#...#.#.....#.......#.#.......#.#.........#.#.#...#.......#.#.....#.#...#...#...#.#...#.....#.....#...#.....#.#...#.#.#
###.#####.#.#.###.#################.#.###.###.#.###.#################.#.#.#.#####.#####.#.#.#######.###.#.#####.###.#####.###.#.#.###.#######.#########.###.#######.###.#.#.#########.#####.#.#.#####.#.#
#.#.#.......#.#.#.......#...#.#.....#...#...#.#.#...#...#...........#.#.#...#.#...#.#.#...#.#.......#.#.....#...#.......#.#...#.#.........#.........#.......#...........#.#...#...#...#.....#...#...#...#
#.#####.###.#.#.###.#.#####.#.#.#####.#.#.#####.###.###.#.#######.#.#######.#.###.#.#.#.#####.###.#.#.###.###################.#.#.#.#.#####.###.###.#.#.#.#.#.#.#####.###.#######.#.#######.#.###.#.#.###
#...#...#...#...#.#.#.#.....#...#...#.#.#...#.#.#.#...#.#.#...#.#.#...#.......#.#.#.#.....#.#.#...#.....#.....#...#...#.......#.#.#.#.#.......#.#...#.#.#.#...#.#.#.....#...#.#...#.#...#...#.#...#.....#
#.###.###########.#.#######.#.#####.#.#.#.#.#.#.#.#.###.###.#.#.#####.###.#.###.#.#.###.###.#####.#######.###.###.#.#####.###.#.###.#.###.###.#######.#.#########.###.#####.#.#.###.###.#.###.#.#.###.###
#.#...#.....#.....#.#.............#...#.#.#.#.#.#.........#.#.....#.#...#.#.........#.#.........#.#.#.#.#.#.....#.......#.#.........#...#.#.....#.#...#...........#...#...#.#.......#.....#...#.#.#.....#
#.###.#####.###.###.#######.#.#.###.#########.#.#.###.###.#.#######.###.#.#.#.###.#.#.#########.###.#.#.###.#.#####.###.#.###.#####.###.#########.#####.#####.#.#.#######.#.###.#####.#####.#####.#.#.###
#.......#.#.#.....#.#.#...#.#.#.#...#...#.#...#.....#.#...#...#.#.#.......#.#...#.#.....#...#.#.....#...#.#.#.#.#.....#...#...#.......#...........#.....#...#.#.#...........#...#.#...#.#.#...#...#.#...#
#.#.#####.#.#####.#.#.#.#####.#####.#.###.#.#######.###.###.###.#.#.###.###.#######.###.#.###.#.#.###.###.#.###.#.#####.#####.###.#####.#####.###.###.#.#.#.#######.#######.#.###.#.#.#.#.#.#########.###
#.#.............#.#.#.......#.#.#.......#.....#.#.....#.#...#.....#.#.....#.....#.....#.......#.#.......#.....#.......#.#.....#...#...#.#.......#.....#...#.....#.......#.....#...#.#.#.#.#...#.....#.#.#
#########.#####.#.#####.#.#.###.#.#####.#.#.###.###.#######.#.###.#####.#####.#####.#####.#######.###.#########.#######.###.#######.#.#######.#######.#.###.###########.###.#####.#####.#.#.#.#.###.###.#
#.#.......#...#.#.#.....#.#.....#...#.....#.#.#.................#.....#...#.#...#.#.#...........#...#...#.....#.#.#...#...#.#.#...#.#.#...#.#.#...#...#.#.....#.....#...#...........#.#.....#.#...#.#...#
#.#.#######.#.###.#####.#############.#.###.#.#.#####.#.#.#####.###.###.###.#####.###.#######.#.###.#.###.###.###.###.#.#.#.#.###.#.#####.#.#####.#.###.#####.###.#############.###.#.###.###.#####.#.###
#...#.#...#.#.............#.#.....#...#...#.....#.....#.#.....#...#.#...#.........#.....#...#.#.#.#.#.#.....#.#.#.#...#.#.#...#.......#.....#...#...#.#.....#...#.....#.....#.#.#.#...#...#.....#.......#
#####.###.###.#######.#####.###.###.#.#########.#######.#######.#########.#####.###.###.#.###.#.#.#########.###.#.#.#####.###.#.#.#.###.###.#.#.#####.###.#.#####.#.#.#####.#.#.#.###########.#.#.#####.#
#.#.............#.....#.......#.....#.#...#...#.#.....#...#.#.#.#...#.#.......#...#.#.......#.#.#...#...#.....#.......#...#...#.#.#.#.#.#.....#.#.#.#.#...#.......#.#.#...#.#...#.....#.....#.#.....#...#
#.#########.#.###.#.#.###.#.#.#########.#.###.#.#.#.#####.#.#.#.###.#.#.#####.###.###########.###.#####.###.#######.###.#.###.#####.#.#####.#####.#.#.###.#####.#####.#.#.#.#.#######.#.###.###########.#
#.......#...#.#.#.#.#.....#.#...#.....#.#.#.......#.#...#.#.#.......#.....#.....#.......#.........#.#.#...#.#...#.#.....#.#.#...........#...#.#...........#.........#...#.#...#.........#...#.....#.....#
#.#.###.#.###.#.###.#######.#########.#.###.#.###.###.#.###.###.#.###.#.#.#.#####.#.#####.#######.#.#.###.#.#.###.#.#######.#.#######.###.#.#.#.###.#####.#.###.#####.#######.###########.#####.#.#.###.#
#.#.#.#.#.#.#...#.........#...#.#.........#.#.#...#.#.#.....#...#.....#.#.#.....#.#.#...........#...#.....#.........#.....#...#.#.#.....#.#...#.#...#.....#.#.....#.......#...#.....#...#.....#.#...#...#
#####.#.###.#.###.###.###.###.#.###.#####.#########.###.#####.#####.#####.#.#.###.###.#####.#.#####.#####.#####.#.#######.#####.#.#.###.###.#####.#######.###.#.#.###########.###.###.###.#.#.#####.#.###
#.#.#.....#.#.#...#...#.#...#.#.#.#.....#...#.#...............#.....#.....#.#...#.........#.#.#...#.#.#.....#...#.....#.....#.#...#.#.....#.....#.#.....#...#.#.#.#.#.#.....#.....#.#...#.#.#.#.#.#.#.#.#
#.#.#.#####.#########.#.#.#.#.#.#.###.#######.#.#.###########.###.#.###.###.###.###.#.#.###.#.#.###.#.#.#####.#######.#.#####.###.###.#.#.#.###.#.#####.#.#.#######.#.#.#########.#.#.###.#.###.#.###.#.#
#...#.......#.#.#.....#.#.#.#.#.................#...........#.#...#.#...#...#.#.#...#.#.#...#...#...#.#...#.#.#.#.#.....#.#.......#.#.#.#.#...#.......#...#...#.......#.....#.#...........#.......#.#.#.#
#.#.#####.#.#.#.#.#.###.#.#.###.#######.#.#####.#######.###.#####.#########.#.#.#####.#####.###.###.#.#.###.###.#.#.#####.#####.#.#.#.#.###.###########.#######.###.#####.###.#####.#.#############.###.#
#.#.......#.......#.....#.#...#...#...#.#.....#...#.....#.#...#...#.....#.#.#.#.#.........#.#...#...#...#.#...#.....#...#.#.#.#.#...#.#...#.....#.............#...#...........#.....#...#...#.#.#...#...#
#####.###.#.###.#####.#.#####.#####.###.#####.#####.#.#.#.#.#.#.###.#####.#.#.#.#########.#####.#####.###.#.#.#.#####.###.#.#.###.###.#####.#####.#.#######.#.#.#.#.#####.###.#.#####.#.#.###.#.#.#.#.###
#.....#.#.#.#.......#.#.....#.......#.......#.#.....#.#.#.#.#.#.......#...#.#.#.#.....#.......#.#...........#.#.....#...#.#.#...#.#...#.....#.#.#.#...#.#...#...#.#.....#...#.#...#...#.#.....#.#.#.....#
#.#####.###.#######.#########.#.###.###.#########.#.#.#.#.#####.###.###.#####.#######.###.#####.#.#####.#####.#######.###.#.#.###.###.#####.#.#.#.#.###.#####.#########.#.#######.#########.###.#.###.#.#
#.........#.#...............#.#.#.......#.....#...#.#.#.....#.#.#.....#.......#...............#.#...#.....#...#...............#.#...#.#...#.#.....#...#.....#.....#.....#.#...#.#.............#...#...#.#
###.#########.#.###.#.#.#############.###.###.#######.###.###.#####.#######.#.#########.#.#####.###.#####.#####.###########.###.#.#######.#####.#####.#.#.#.#####.#########.###.#.###.#####.#.#.###.#.###
#.#.....#...#.#...#.#.#.........#.......#.#.......#.#.#.#...#.#...#.........#.#.#.#.....#.#...#...#.#.....................#...............#...#...#...#.#.#.#.......#...............#.....#.#.#...#.#...#
#.#######.#.#.#######.###.###########.#######.###.#.###.#.###.#.#########.#.###.#.#.#.###.#.###.#####.###.###########.#######.#.#.###.###.#.#.#.#.###.###.###.#.#####.###.#####.#####.#####.#####.#.#.###
#.#.#.#.#.#.......#.#.#.#.........#.#.......#...#.#.#.#.#...#.#.#.#.#...#.#.#.#...#.#...#.....#.#.....#...#.#.#.........#.#...#.#.#...#.....#...#...#.....#.#.#.#.#...#...#...#.#...#.#.....#.....#.#...#
#.#.#.#.#.#.#####.#.###.#.#.###.###.###.###.#.#####.#.#.###.#.#.#.#.#.###.#.#.#.###.###.###.#####.#.###.#.#.#.#.###.#.#.#.###############.#####.###########.#.###.#.#.###.###.#####.###.###.#.###.###.#.#
#.........#.#.......#.....#.#.......#.....#...#.....................#.....#.....#.....#...#.....#.#...#.#.....#.#...#.#.............#.......#.......#.............#.#...#.............#...#...#...#...#.#
#########################################################################################################################################################################################################