#########################################
#...#.....#.........#.#.#.#.#.#.........#
#.###.#.#.#.###.###.#.#.#.#.#.#.#.#####.#
#...#.#.#.....#.#.....#.......#.#.#...#.#
###.#########.#.###.#.#.#.###.#.#.#.###.#
#.#.....#.#.#.#.#.#.#.#.#.#...#.#...#...#
#.###.###.#.#.###.#.#.#####.###.#####.#.#
#...#.......#...#...#...#...#.....#...#.#
#.#.###.#########.#.###.#.#.#####.#####.#
#.#...#...#.....#.#.#.#.#.#.......#...#.#
#.#.#.#.###.#.###.#.#.#####.#.###.#.#.#.#
#.#.#...#...#...#.#.#.#.....#.#.#...#.#.#
#.#.#####.###.#.#.###.###.###.#.###.#.#.#
#.#...#.#.#.#.#.#.....#.....#...#...#.#.#
#.###.#.#.#.#########.#.###.#.#####.#.###
#...#.....#.......#...#.#...#.#.....#...#
#.#####.#.###.###.###.###.#######.#.#.#.#
#...#.#.#.....#...........#.#.....#.#.#.#
#.###.#.###.#.#######.#####.#.#.#.#.#.###
#.....#.#...#.#.......#.......#.#.#.#...#
#########################################