#########################################
#...#.....#...#.........#.#.#...#.......#
#.###.#.###.#.###.###.#.#.#.#.#.#.#.###.#
#...#.#...#.#.#.....#.#...#...#...#...#.#
#.###.#####.#.#.###.###.#######.#########
#.....#...#.#...#...#.#.#.#...#.....#...#
#.#####.#############.#.#.#.#######.###.#
#...........#.#.....#.............#.....#
#####.#####.#.#####.#.###.#####.#####.###
#.#.......#.......#.#.#.....#.#.#.......#
#.#.#.###.#########.#########.#.#.###.#.#
#...#.#.......#.......#...#...#.....#.#.#
#.###.#######.###.#.#.#.#.#.#.#.#.#####.#
#.#.#.......#.....#.#...#...#.#.#.#.#...#
#.#.###.#.#######.#.#####.#######.#.#####
#.....#.#.#...#...#...#.....#.#...#.....#
#.#####.#.#.#########.###.#.#.#.#####.###
#.#.....#.......#...#...#.#.#...#.#.....#
#.#.#.#.#.###.#.#.#.#.#.###.#.#.#.#####.#
#.#.#.#.#.#...#...#.#.#...#...#.........#
#########################################