#######################
#.....................#
#.#.#.#.#.#.#.#.#.#.#.#
#.....................#
#.#.#.#.#.#.#.#.#.#.#.#
#.......#..>..........#
#.#.#.#.#.###.#.#.#.#.#
#.....................#
#.#.#.#.#.#.#.#.#.#.#.#
#.....................#
#######################