#############################################################
#.....#.#.....#.....#.....#...........#.........#.....#.....#
#.#.#.#.#.#.###.#.#.#.###.#######.#.#####.#####.#.###.#.#.###
#.#.#.....#...#.#.#.....#.....#...#.#...#...#...#.#.....#...#
#.###########.#.###.#.#.#####.#.###.#.###.###.#####.###.###.#
#.....#...#...#.#.#.#.#...#.#...#.........#...#.#.....#.#.#.#
#.#.###.#####.#.#.###.###.#.###.#####.###.###.#.#####.###.#.#
#.#.#.......#.#.#.#...#...#.#.......#.#.....#.......#...#...#
#.###.#.###.###.#.###.#####.#######.#############.#.#.#.###.#
#...#.#.#.......#.........#.....#...#.....#.......#.#.#.#.#.#
#.###.#.#########.#########.###.#.###.#####.#.#.###.###.#.#.#
#...#.#...#.#...........#.....#.#.#.#...#.#.#.#...#.#.#...#.#
#.#########.#####.#############.#.#.#.###.#.#####.#.#.#.###.#
#.............#.....#...#.#.#...#...#.....#.....#.#.......#.#
#.###.#.###.###.#####.###.#.###.#.#.#.#.#.#.#.###########.#.#
#...#.#...#.....#.....#.....#.....#.#.#.#...#.........#.#.#.#
#####.#######.#.#.#######.###.#######.#####.###.#######.###.#
#.#.....#...#.#.#.#.#.#...#...#.......#.#...#.......#...#...#
#.#######.#####.#.#.#.#.#####.#.#.#####.###########.#.###.###
#.......#.......#...#.#...#...#.#...........#.....#.#...#...#
#.#######.#.#.#.###.#.#.#.#################.###.###.#.#.#####
#.#.#.#...#.#.#.#.#.#...#.#.#...#.#.........#.#.......#.#...#
#.#.#.###.###.###.#.#.#.###.#.###.#.#.#######.#.###.#####.###
#.#.....#.#.....#.....#.....#.#.#.#.#.#.........#.......#.#.#
#.###.#.#######.#.#######.###.#.#.#########.#########.###.#.#
#.....#.......#.#.....#.........#.....#.......#.......#.....#
#.###.#####.###.#.###.#.###.#####.#.#####.###.###.###.#.#####
#.#...#.........#...#.#...#.#.....#.........#.#.....#.#...#.#
#.#########.#.#.#.#.#.#.#########.###.###########.###.#.###.#
#.........#.#.#...#.#.#...#.........#...#...........#.......#
#############################################################